NO ../textures/text1.xpm
SO ../textures/text2.xpm
WE ../textures/text3.xpm
EA ../textures/text4.xpm

111111111111111111111111
100000000000000000000101
100000000001000000000101
100010101010101010000001
100000000000000000000001
100000000000000010000001
100000000000000010000101
100000000000000010000101
100000000000011110000001
100000001000011110000101
100000000100011110000101
100000000000000000000101
1000000E0000000010000001
100000000000000000000101
111111111111111111111111