NO   	../textures/text1.xpm
SO ../textures/text2.xpm
WE      ../textures/text3.xpm
EA      ../textures/text4.xpm
C     52, 126,223

F   179, 179, 208







        111111111111111111111
        100000000011000000001
        101100000111000000001
        100100000000000000001
11111111101100000111000000001
100000000011000001110111101111
1111011111111101110000001000111111
11110111111111011101010010001111
11000000110101011100000000001
10000100000000001100000010001
10001010000000001101010010001
11000101110101011111011110001
11110111 1110101 1011110100N1
11111111 1111111 111111111111