NO   	../textures/text1.xpm
SO ../textures/text2.xpm

WE      ../textures/text3.xpm

EA ../textures/text4.xpm


C 52,226,223


F 179,179,208

 111111111111111111111111
100000000000000000000101
100000000001000000000101
100010101010101010000001
100000000000000000000001
100000000000000010000001
100000000000000010000101
100000000000000010000101
100000000000011110000001
100000010000011110000101
100000101000011110000101
100000010000000000000101
100000000000000010000001
100000000000000000000001
10000000E000000100000101
100000000000000000000101
111111111111111111111111